11000000
00001000
00001000
11000000
00000000
00001000
00001001
00000001